这部电影的导演是谁	director
这部电影的主演有哪些	actor
这部电影是什么类型的	genre
这部电影的评分是多少	rating
这部电影是哪年上映的	year
这部电影的评价人数有多少	review_count
这部电影是在哪个国家拍摄的	country
这部电影使用什么语言	language
这部电影的编剧是谁	writer
这部电影的剧情简介是什么	plot
这部电影的获奖情况如何	award
这部电影的票房是多少	box_office
这部电影的时长是多少	duration
这部电影的推荐指数是多少	recommendation
这部电影适合什么年龄段观看	age_rating
这部电影的拍摄地点在哪里	location
这部电影的配乐是谁做的	music
这部电影的特效是谁做的	effects
这部电影的服装设计是谁做的	costume
这部电影的摄影指导是谁	photography
这部电影的剪辑是谁做的	editing
这部电影的制作公司是哪家	production_company
这部电影的发行公司是哪家	distribution_company
这部电影的预算是多少	budget
这部电影的拍摄周期是多久	shooting_period
这部电影的拍摄地点有哪些	shooting_locations
这部电影的拍摄技术是什么	shooting_technique
这部电影的拍摄设备是什么	shooting_equipment
这部电影的拍摄团队有多少人	crew_size
这部电影的后期制作花了多久	post_production
这部电影的预告片在哪里看	trailer
这部电影的剧照在哪里看	still_photos
这部电影的花絮在哪里看	behind_the_scenes
这部电影的删减片段在哪里看	deleted_scenes
这部电影的导演剪辑版在哪里看	directors_cut
这部电影的蓝光版什么时候出	bluray_release
这部电影的DVD版什么时候出	dvd_release
这部电影的流媒体版什么时候出	streaming_release
这部电影的IMAX版在哪里看	imax_version
这部电影的3D版在哪里看	3d_version
这部电影的4K版在哪里看	4k_version
这部电影的杜比视界版在哪里看	dolby_vision
这部电影的杜比全景声版在哪里看	dolby_atmos
这部电影的IMAX Enhanced版在哪里看	imax_enhanced
这部电影的4DX版在哪里看	4dx_version
这部电影的ScreenX版在哪里看	screenx_version
这部电影的D-BOX版在哪里看	dbox_version
这部电影的MX4D版在哪里看	mx4d_version
这部电影的4D版在哪里看	4d_version
这部电影的VR版在哪里看	vr_version
这部电影的AR版在哪里看	ar_version
这部电影的互动版在哪里看	interactive_version
这部电影的导演评论音轨在哪里听	director_commentary
这部电影的演员评论音轨在哪里听	actor_commentary
这部电影的编剧评论音轨在哪里听	writer_commentary
这部电影的配乐师评论音轨在哪里听	composer_commentary
这部电影的摄影师评论音轨在哪里听	photographer_commentary
这部电影的剪辑师评论音轨在哪里听	editor_commentary
这部电影的特效师评论音轨在哪里听	effects_commentary
这部电影的服装设计师评论音轨在哪里听	costume_commentary
这部电影的美术指导评论音轨在哪里听	art_director_commentary
这部电影的制片人评论音轨在哪里听	producer_commentary
这部电影的影评人评论音轨在哪里听	critic_commentary
这部电影的幕后花絮在哪里看	behind_the_scenes
这部电影的拍摄日记在哪里看	shooting_diary
这部电影的剧本在哪里看	script
这部电影的分镜脚本在哪里看	storyboard
这部电影的概念图在哪里看	concept_art
这部电影的服装设计图在哪里看	costume_design
这部电影的场景设计图在哪里看	set_design
这部电影的道具设计图在哪里看	prop_design
这部电影的特效设计图在哪里看	effects_design
这部电影的配乐在哪里听	soundtrack
这部电影的主题曲在哪里听	theme_song
这部电影的插曲在哪里听	insert_song
这部电影的片尾曲在哪里听	end_credits_song
这部电影的配乐专辑在哪里买	soundtrack_album
这部电影的原声带在哪里买	original_soundtrack
这部电影的配乐CD在哪里买	soundtrack_cd
这部电影的配乐黑胶在哪里买	soundtrack_vinyl
这部电影的配乐数字版在哪里买	soundtrack_digital
这部电影的配乐流媒体在哪里听	soundtrack_streaming
这部电影的配乐下载在哪里买	soundtrack_download
这部电影的配乐铃声在哪里买	soundtrack_ringtone
这部电影的配乐铃声下载在哪里买	soundtrack_ringtone_download
这部电影的配乐铃声流媒体在哪里听	soundtrack_ringtone_streaming
这部电影的配乐铃声CD在哪里买	soundtrack_ringtone_cd
这部电影的配乐铃声黑胶在哪里买	soundtrack_ringtone_vinyl
这部电影的配乐铃声数字版在哪里买	soundtrack_ringtone_digital
这部电影的配乐铃声流媒体在哪里听	soundtrack_ringtone_streaming
这部电影的配乐铃声下载在哪里买	soundtrack_ringtone_download
这部电影的配乐铃声CD在哪里买	soundtrack_ringtone_cd
这部电影的配乐铃声黑胶在哪里买	soundtrack_ringtone_vinyl
这部电影的配乐铃声数字版在哪里买	soundtrack_ringtone_digital
给我推荐一部电影	movie_recommendation
推荐一部动作片	genre_recommendation
推荐一部喜剧片	genre_recommendation
推荐一部科幻片	genre_recommendation
推荐一部恐怖片	genre_recommendation
推荐一部爱情片	genre_recommendation
推荐一部动画片	genre_recommendation
推荐一部纪录片	genre_recommendation
推荐一部悬疑片	genre_recommendation
推荐一部犯罪片	genre_recommendation
推荐与这部电影相似的电影	similar_movie
给我推荐类似的电影	similar_movie
有没有类似的电影推荐	similar_movie
想看类似风格的电影	similar_movie
有什么相似题材的电影	similar_movie 